### Endsieg Tags ###

EFR = "countries/France.txt"
ANA = "countries/USA.txt"
AUH = "countries/Austria-Hungary.txt"
AUT = "countries/Austria-Hungary.txt"
BAV = "countries/Soviet Bavaria.txt"
BOH = "countries/Bohemia.txt"
BVR = "countries/Bavaria.txt"
CYU = "countries/Yugoslavia.txt"
CAL = "countries/Albania.txt"
CBU = "countries/Bulgaria.txt"
CCZ = "countries/Czechoslovakia.txt"
CMN = "countries/Communist Romania.txt"
CPO = "countries/Poland.txt"
DAN = "countries/Poland.txt"
DIT = "countries/Italy.txt"
DGR = "countries/Greece.txt"
DER = "countries/Dervish State.txt"
FAR = "countries/Far Estern Republic.txt"
FLA = "countries/Flanders.txt"
GAL = "countries/Kingdom of Galicia and Lodomeria.txt"
HEL = "countries/Greece.txt"
IND = "countries/British Raj.txt"
IRA = "countries/AntiTreaty Ireland.txt"
KIT = "countries/Italy.txt"
KOP = "countries/Poland.txt"
KUO = "countries/Kuomintang.txt"
LOK = "countries/Lokot Autonomy.txt"
MDS = "countries/Maderistas.txt"
MRN = "countries/Mountainous Republic.txt"
NEJ = "countries/Emirate of Nejd.txt"
NOK = "countries/North Korea.txt"
NPA = "countries/National Protection Army.txt"
PRM = "countries/Prekmurje.txt"
POM = "countries/Kingdom of Portugal.txt"
RCH = "countries/China.txt"
RIR = "countries/Rif Republic.txt"
RKK = "countries/Reichskom Kaukasus.txt"
RKO = "countries/Reichskom Ostland.txt"
RKU = "countries/Reichskom Ukaine.txt"
RRE = "countries/Russian Republic.txt"
RUS = "countries/Russian Empire.txt"
SAR = "countries/South African Republic.txt"
SES = "countries/Senussi Order.txt"
SHA = "countries/Shammar.txt"
SOK = "countries/South Korea.txt"
SPE = "countries/PSSR.txt"
SLG = "countries/Schleswig-Holstein.txt"
SNG = "countries/Senegal.txt"
TRC = "countries/Transcaucasian Republic.txt"
TSS = "countries/Communist Crimea.txt"
UBD = "countries/United Baltic Duchy.txt"
VIL = "countries/Mexico.txt"
WAL = "countries/Wallonia.txt"
WAS = "countries/Wasteland.txt"
WRT = "countries/Wurttemburg-Baden.txt"
ZAP = "countries/Mexico.txt"
USC = "countries/USA.txt"
HEJ = "countries/Hejaz.txt"

#WW1 list

WHR = "countries/White Russia.txt"
EN3 = "countries/United Kingdom.txt"
DKR = "countries/Don Kuban Republic.txt"
RO2 = "countries/Romania.txt"
QIN = "countries/Qing Empire.txt"
BAK = "countries/Baku Commune.txt"
BNT = "countries/Banat Republic.txt"
CNT = "countries/Constitucionalistas.txt"
FNN = "countries/White Finland.txt"
FNR = "countries/Red Finland.txt"